F???? 	independence=7 	domination=7
F??C? 	independence=6 	domination=6
F??E? 	independence=6 	domination=5
F??F? 	independence=6 	domination=4
F??F_ 	independence=6 	domination=3
F??Fo 	independence=6 	domination=2
F??Fw 	independence=6 	domination=1
F?AA? 	independence=5 	domination=5
F?AE? 	independence=5 	domination=5
F?AB? 	independence=5 	domination=4
F?ACG 	independence=5 	domination=5
F?AF? 	independence=5 	domination=4
F?AB_ 	independence=5 	domination=3
F?AEG 	independence=5 	domination=4
F?AF_ 	independence=5 	domination=3
F?ABo 	independence=5 	domination=2
F?AFG 	independence=5 	domination=3
F?AFo 	independence=5 	domination=2
F?AFg 	independence=5 	domination=2
F?AFw 	independence=5 	domination=1
F?BE? 	independence=5 	domination=5
F?B@_ 	independence=5 	domination=3
F?BF? 	independence=5 	domination=4
F?BD_ 	independence=5 	domination=3
F?B@o 	independence=5 	domination=2
F?BEG 	independence=5 	domination=4
F?BDG 	independence=5 	domination=4
F?B@g 	independence=5 	domination=3
F?BF_ 	independence=5 	domination=3
F?BDo 	independence=5 	domination=2
F?BFG 	independence=5 	domination=3
F?BDg 	independence=5 	domination=3
F?B@w 	independence=5 	domination=2
F?BFo 	independence=5 	domination=2
F?BFg 	independence=5 	domination=2
F?BDw 	independence=5 	domination=2
F?BFw 	independence=5 	domination=1
F?Bf? 	independence=5 	domination=4
F?Be_ 	independence=5 	domination=3
F?Bco 	independence=5 	domination=2
F?Bf_ 	independence=5 	domination=3
F?Beo 	independence=5 	domination=2
F?BfG 	independence=5 	domination=3
F?Beg 	independence=5 	domination=3
F?Bcw 	independence=5 	domination=2
F?Bfo 	independence=5 	domination=2
F?Bfg 	independence=5 	domination=2
F?Bew 	independence=5 	domination=2
F?Bfw 	independence=5 	domination=1
F?Bv_ 	independence=5 	domination=3
F?BvO 	independence=5 	domination=2
F?Bvo 	independence=5 	domination=2
F?Bvg 	independence=5 	domination=2
F?BvW 	independence=5 	domination=2
F?Bvw 	independence=5 	domination=1
F?B~o 	independence=5 	domination=2
F?B~w 	independence=5 	domination=1
F?`@? 	independence=4 	domination=4
F?`E? 	independence=5 	domination=5
F?`D? 	independence=4 	domination=4
F?`@_ 	independence=4 	domination=3
F?`CO 	independence=4 	domination=4
F?`F? 	independence=4 	domination=4
F?`D_ 	independence=4 	domination=3
F?`EO 	independence=4 	domination=4
F?`DO 	independence=4 	domination=3
F?`F_ 	independence=4 	domination=3
F?`FO 	independence=4 	domination=3
F?`Do 	independence=4 	domination=2
F?`EW 	independence=4 	domination=3
F?`Fo 	independence=4 	domination=2
F?`FW 	independence=4 	domination=2
F?`Fw 	independence=4 	domination=1
F?bAO 	independence=4 	domination=4
F?bF? 	independence=4 	domination=4
F?bB_ 	independence=4 	domination=3
F?bEO 	independence=4 	domination=4
F?bBO 	independence=4 	domination=3
F?bEG 	independence=4 	domination=4
F?bDG 	independence=4 	domination=4
F?bF_ 	independence=4 	domination=3
F?bFO 	independence=4 	domination=3
F?bDo 	independence=4 	domination=2
F?bBo 	independence=4 	domination=2
F?bFG 	independence=4 	domination=3
F?bDg 	independence=4 	domination=3
F?bEW 	independence=4 	domination=3
F?bFo 	independence=4 	domination=2
F?bFg 	independence=4 	domination=2
F?bFW 	independence=4 	domination=2
F?bFw 	independence=4 	domination=1
F?`e? 	independence=4 	domination=4
F?`b? 	independence=4 	domination=4
F?`c_ 	independence=4 	domination=3
F?`cO 	independence=4 	domination=3
F?`f? 	independence=4 	domination=4
F?`e_ 	independence=4 	domination=3
F?`b_ 	independence=4 	domination=3
F?`eO 	independence=4 	domination=3
F?`co 	independence=4 	domination=2
F?`eG 	independence=4 	domination=4
F?`bG 	independence=4 	domination=3
F?`cg 	independence=4 	domination=3
F?`ag 	independence=4 	domination=3
F?`cW 	independence=4 	domination=3
F?`f_ 	independence=4 	domination=3
F?`fO 	independence=4 	domination=3
F?`eo 	independence=4 	domination=2
F?`fG 	independence=4 	domination=3
F?`eg 	independence=4 	domination=3
F?`bg 	independence=4 	domination=2
F?`eW 	independence=4 	domination=3
F?`cw 	independence=4 	domination=2
F?`fo 	independence=4 	domination=2
F?`fg 	independence=4 	domination=2
F?`fW 	independence=4 	domination=2
F?`ew 	independence=4 	domination=2
F?`fw 	independence=4 	domination=1
F?aJ_ 	independence=4 	domination=2
F?aKW 	independence=4 	domination=4
F?aN_ 	independence=4 	domination=2
F?aNO 	independence=4 	domination=3
F?aMW 	independence=4 	domination=3
F?aNo 	independence=4 	domination=2
F?aNW 	independence=4 	domination=2
F?aNw 	independence=4 	domination=1
F?bbO 	independence=4 	domination=3
F?bao 	independence=4 	domination=2
F?bf_ 	independence=4 	domination=3
F?bfO 	independence=4 	domination=3
F?beo 	independence=4 	domination=2
F?bbo 	independence=4 	domination=2
F?bfG 	independence=4 	domination=3
F?beg 	independence=4 	domination=3
F?beW 	independence=4 	domination=3
F?bbW 	independence=4 	domination=3
F?bcw 	independence=4 	domination=2
F?baw 	independence=4 	domination=2
F?bfo 	independence=4 	domination=2
F?bfg 	independence=4 	domination=2
F?bfW 	independence=4 	domination=2
F?bew 	independence=4 	domination=2
F?bbw 	independence=4 	domination=2
F?bfw 	independence=4 	domination=1
F?`v? 	independence=4 	domination=3
F?`r_ 	independence=4 	domination=3
F?`uO 	independence=4 	domination=2
F?`v_ 	independence=4 	domination=3
F?`vO 	independence=4 	domination=2
F?`vG 	independence=4 	domination=3
F?`rg 	independence=4 	domination=2
F?`uW 	independence=4 	domination=2
F?`vo 	independence=4 	domination=2
F?`vg 	independence=4 	domination=2
F?`vW 	independence=4 	domination=2
F?`vw 	independence=4 	domination=1
F?bN_ 	independence=4 	domination=2
F?bNO 	independence=4 	domination=3
F?bLo 	independence=4 	domination=2
F?bMW 	independence=4 	domination=3
F?bLW 	independence=4 	domination=3
F?bNo 	independence=4 	domination=2
F?bNg 	independence=4 	domination=2
F?bNW 	independence=4 	domination=2
F?bLw 	independence=4 	domination=2
F?bNw 	independence=4 	domination=1
F?bv_ 	independence=4 	domination=3
F?bvO 	independence=4 	domination=2
F?bro 	independence=4 	domination=2
F?bvo 	independence=4 	domination=2
F?bvg 	independence=4 	domination=2
F?bvW 	independence=4 	domination=2
F?brw 	independence=4 	domination=2
F?bvw 	independence=4 	domination=1
F?bnO 	independence=4 	domination=3
F?bmo 	independence=4 	domination=2
F?bno 	independence=4 	domination=2
F?bnW 	independence=4 	domination=2
F?bmw 	independence=4 	domination=2
F?bnw 	independence=4 	domination=1
F?b~o 	independence=4 	domination=2
F?b~w 	independence=4 	domination=1
F?rF? 	independence=4 	domination=4
F?rEO 	independence=4 	domination=4
F?rF_ 	independence=4 	domination=3
F?rFO 	independence=4 	domination=3
F?rDo 	independence=4 	domination=2
F?rEW 	independence=4 	domination=3
F?rFo 	independence=4 	domination=2
F?rFW 	independence=4 	domination=2
F?rFw 	independence=4 	domination=1
F?qb? 	independence=4 	domination=4
F?qf? 	independence=4 	domination=4
F?qb_ 	independence=4 	domination=3
F?qdO 	independence=4 	domination=4
F?qbO 	independence=4 	domination=3
F?q`o 	independence=4 	domination=3
F?qcW 	independence=4 	domination=4
F?qaW 	independence=4 	domination=3
F?q_w 	independence=4 	domination=3
F?qf_ 	independence=4 	domination=3
F?qfO 	independence=4 	domination=3
F?qeo 	independence=4 	domination=2
F?qdo 	independence=4 	domination=3
F?qbo 	independence=4 	domination=2
F?qeW 	independence=4 	domination=3
F?qbW 	independence=4 	domination=3
F?qcw 	independence=4 	domination=3
F?qaw 	independence=4 	domination=2
F?qfo 	independence=4 	domination=2
F?qfW 	independence=4 	domination=2
F?qew 	independence=4 	domination=2
F?qbw 	independence=4 	domination=2
F?qfw 	independence=4 	domination=1
F?ou? 	independence=4 	domination=3
F?ov? 	independence=4 	domination=3
F?ouO 	independence=4 	domination=2
F?otO 	independence=4 	domination=3
F?opo 	independence=4 	domination=3
F?osW 	independence=4 	domination=3
F?ov_ 	independence=4 	domination=3
F?ovO 	independence=4 	domination=2
F?oto 	independence=4 	domination=3
F?ouW 	independence=4 	domination=2
F?otW 	independence=4 	domination=3
F?ovo 	independence=4 	domination=2
F?ovW 	independence=4 	domination=2
F?ovw 	independence=4 	domination=1
F?rf? 	independence=4 	domination=4
F?re_ 	independence=4 	domination=3
F?reO 	independence=4 	domination=3
F?rf_ 	independence=4 	domination=3
F?rfO 	independence=4 	domination=3
F?reo 	independence=4 	domination=2
F?rdo 	independence=4 	domination=2
F?rfG 	independence=4 	domination=3
F?reg 	independence=4 	domination=3
F?rfo 	independence=4 	domination=2
F?rfg 	independence=4 	domination=2
F?rfW 	independence=4 	domination=2
F?rew 	independence=4 	domination=2
F?rdw 	independence=4 	domination=2
F?rfw 	independence=4 	domination=1
F?qr_ 	independence=4 	domination=3
F?qrO 	independence=4 	domination=2
F?qpo 	independence=4 	domination=3
F?qv_ 	independence=4 	domination=3
F?qvO 	independence=4 	domination=2
F?qto 	independence=4 	domination=3
F?qro 	independence=4 	domination=2
F?qvG 	independence=4 	domination=3
F?qtg 	independence=4 	domination=2
F?qrg 	independence=4 	domination=2
F?quW 	independence=4 	domination=2
F?qvo 	independence=4 	domination=2
F?qvg 	independence=4 	domination=2
F?qvW 	independence=4 	domination=2
F?qtw 	independence=4 	domination=2
F?qrw 	independence=4 	domination=2
F?qvw 	independence=4 	domination=1
F?rN_ 	independence=4 	domination=2
F?rNO 	independence=4 	domination=3
F?rMW 	independence=4 	domination=3
F?rNo 	independence=4 	domination=2
F?rNW 	independence=4 	domination=2
F?rLw 	independence=4 	domination=2
F?rNw 	independence=4 	domination=1
F?qn_ 	independence=4 	domination=2
F?qnO 	independence=4 	domination=3
F?qmo 	independence=4 	domination=2
F?qlo 	independence=4 	domination=2
F?qjo 	independence=4 	domination=2
F?qmW 	independence=4 	domination=3
F?qjW 	independence=4 	domination=3
F?qkw 	independence=4 	domination=3
F?qno 	independence=4 	domination=2
F?qnW 	independence=4 	domination=2
F?qmw 	independence=4 	domination=2
F?qjw 	independence=4 	domination=2
F?qnw 	independence=4 	domination=1
F?o~_ 	independence=4 	domination=2
F?o~O 	independence=4 	domination=2
F?o|o 	independence=4 	domination=2
F?o}W 	independence=4 	domination=2
F?o|W 	independence=4 	domination=3
F?o~o 	independence=4 	domination=2
F?o~W 	independence=4 	domination=2
F?o~w 	independence=4 	domination=1
F?rv_ 	independence=4 	domination=3
F?rvo 	independence=4 	domination=2
F?rvg 	independence=4 	domination=2
F?rvw 	independence=4 	domination=1
F?rn_ 	independence=4 	domination=2
F?rno 	independence=4 	domination=2
F?rng 	independence=4 	domination=2
F?rnW 	independence=4 	domination=2
F?rmw 	independence=4 	domination=2
F?rnw 	independence=4 	domination=1
F?q~_ 	independence=4 	domination=2
F?q~o 	independence=4 	domination=2
F?q~g 	independence=4 	domination=2
F?q~W 	independence=4 	domination=2
F?q|w 	independence=4 	domination=2
F?qzw 	independence=4 	domination=2
F?q~w 	independence=4 	domination=1
F?r~o 	independence=4 	domination=2
F?r~w 	independence=4 	domination=1
F?zf? 	independence=4 	domination=4
F?zf_ 	independence=4 	domination=3
F?zfO 	independence=4 	domination=3
F?zeW 	independence=4 	domination=3
F?zcw 	independence=4 	domination=2
F?zfo 	independence=4 	domination=2
F?zfW 	independence=4 	domination=2
F?zew 	independence=4 	domination=2
F?zfw 	independence=4 	domination=1
F?zV_ 	independence=4 	domination=3
F?zVO 	independence=4 	domination=2
F?zUo 	independence=4 	domination=3
F?zTo 	independence=4 	domination=2
F?zUW 	independence=4 	domination=3
F?zTW 	independence=4 	domination=2
F?zPw 	independence=4 	domination=2
F?zVo 	independence=4 	domination=2
F?zVW 	independence=4 	domination=2
F?zTw 	independence=4 	domination=2
F?zVw 	independence=4 	domination=1
F?zv_ 	independence=4 	domination=3
F?zvO 	independence=4 	domination=2
F?zuo 	independence=4 	domination=2
F?zvo 	independence=4 	domination=2
F?zvg 	independence=4 	domination=2
F?zvw 	independence=4 	domination=1
F?zno 	independence=4 	domination=2
F?znW 	independence=4 	domination=2
F?zmw 	independence=4 	domination=2
F?znw 	independence=4 	domination=1
F?z^o 	independence=4 	domination=2
F?z\w 	independence=4 	domination=2
F?z^w 	independence=4 	domination=1
F?z~w 	independence=4 	domination=1
F?~v_ 	independence=4 	domination=3
F?~vo 	independence=4 	domination=2
F?~vW 	independence=4 	domination=2
F?~vw 	independence=4 	domination=1
F?~~w 	independence=4 	domination=1
FCOe? 	independence=4 	domination=4
FCOc_ 	independence=3 	domination=3
FCOf? 	independence=4 	domination=4
FCOe_ 	independence=3 	domination=3
FCOf_ 	independence=3 	domination=3
FCOeo 	independence=3 	domination=2
FCOfo 	independence=3 	domination=2
FCOfw 	independence=3 	domination=1
FCQb? 	independence=4 	domination=4
FCQ`_ 	independence=3 	domination=3
FCQaO 	independence=3 	domination=3
FCQf? 	independence=4 	domination=4
FCQe_ 	independence=3 	domination=3
FCQd_ 	independence=3 	domination=3
FCQb_ 	independence=3 	domination=3
FCQeO 	independence=3 	domination=3
FCQbO 	independence=3 	domination=3
FCQeG 	independence=4 	domination=4
FCQf_ 	independence=3 	domination=3
FCQfO 	independence=3 	domination=3
FCQeo 	independence=3 	domination=2
FCQbo 	independence=3 	domination=2
FCQfG 	independence=3 	domination=3
FCQdg 	independence=3 	domination=2
FCQeW 	independence=3 	domination=3
FCQfo 	independence=3 	domination=2
FCQfg 	independence=3 	domination=2
FCQfW 	independence=3 	domination=2
FCQfw 	independence=3 	domination=1
FCQQO 	independence=3 	domination=3
FCQU_ 	independence=4 	domination=4
FCQT_ 	independence=3 	domination=3
FCQUO 	independence=3 	domination=3
FCQRO 	independence=3 	domination=2
FCQSg 	independence=3 	domination=3
FCQV_ 	independence=3 	domination=3
FCQVO 	independence=3 	domination=2
FCQUo 	independence=3 	domination=3
FCQUg 	independence=3 	domination=3
FCQTg 	independence=3 	domination=2
FCQVo 	independence=3 	domination=2
FCQVg 	independence=3 	domination=2
FCQUw 	independence=3 	domination=2
FCQVw 	independence=3 	domination=1
FCR`o 	independence=3 	domination=2
FCRf_ 	independence=3 	domination=3
FCReo 	independence=3 	domination=2
FCRdo 	independence=3 	domination=2
FCRfG 	independence=3 	domination=3
FCReg 	independence=3 	domination=3
FCRdg 	independence=3 	domination=2
FCRbg 	independence=3 	domination=3
FCRcw 	independence=3 	domination=2
FCR`w 	independence=3 	domination=2
FCRfo 	independence=3 	domination=2
FCRfg 	independence=3 	domination=2
FCRew 	independence=3 	domination=2
FCRdw 	independence=3 	domination=2
FCRfw 	independence=3 	domination=1
FCRV? 	independence=3 	domination=3
FCRUO 	independence=3 	domination=3
FCRV_ 	independence=3 	domination=3
FCRVO 	independence=3 	domination=2
FCRUo 	independence=3 	domination=3
FCRTo 	independence=3 	domination=2
FCRUg 	independence=3 	domination=3
FCRUW 	independence=3 	domination=3
FCRSw 	independence=3 	domination=3
FCRVo 	independence=3 	domination=2
FCRVg 	independence=3 	domination=2
FCRVW 	independence=3 	domination=2
FCRUw 	independence=3 	domination=2
FCRTw 	independence=3 	domination=2
FCRVw 	independence=3 	domination=1
FCQrO 	independence=3 	domination=2
FCQv_ 	independence=3 	domination=3
FCQvO 	independence=3 	domination=2
FCQuo 	independence=3 	domination=2
FCQug 	independence=3 	domination=3
FCQtg 	independence=3 	domination=2
FCQuW 	independence=3 	domination=2
FCQrW 	independence=3 	domination=2
FCQvo 	independence=3 	domination=2
FCQvg 	independence=3 	domination=2
FCQvW 	independence=3 	domination=2
FCQuw 	independence=3 	domination=2
FCQvw 	independence=3 	domination=1
FCRv_ 	independence=3 	domination=3
FCRvO 	independence=3 	domination=2
FCRuo 	independence=3 	domination=2
FCRto 	independence=3 	domination=2
FCRvo 	independence=3 	domination=2
FCRvg 	independence=3 	domination=2
FCRvW 	independence=3 	domination=2
FCRuw 	independence=3 	domination=2
FCRtw 	independence=3 	domination=2
FCRvw 	independence=3 	domination=1
FCR]o 	independence=3 	domination=3
FCR^o 	independence=3 	domination=2
FCR]w 	independence=3 	domination=2
FCR^w 	independence=3 	domination=1
FCR~o 	independence=3 	domination=2
FCR~w 	independence=3 	domination=1
FCp`_ 	independence=3 	domination=3
FCpf? 	independence=4 	domination=4
FCpe_ 	independence=3 	domination=3
FCpd_ 	independence=3 	domination=3
FCpb_ 	independence=3 	domination=3
FCpeO 	independence=3 	domination=3
FCpdO 	independence=3 	domination=3
FCpbO 	independence=3 	domination=3
FCpeG 	independence=4 	domination=4
FCpdG 	independence=3 	domination=3
FCpf_ 	independence=3 	domination=3
FCpfO 	independence=3 	domination=3
FCpeo 	independence=3 	domination=2
FCpdo 	independence=3 	domination=2
FCpbo 	independence=3 	domination=3
FCpfG 	independence=3 	domination=3
FCpeg 	independence=3 	domination=3
FCpdg 	independence=3 	domination=2
FCpeW 	independence=3 	domination=3
FCpfo 	independence=3 	domination=2
FCpfg 	independence=3 	domination=2
FCpfW 	independence=3 	domination=2
FCpfw 	independence=3 	domination=1
FCpV? 	independence=3 	domination=3
FCpU_ 	independence=4 	domination=4
FCpUO 	independence=3 	domination=3
FCpV_ 	independence=3 	domination=3
FCpVO 	independence=3 	domination=2
FCpUo 	independence=3 	domination=3
FCpVo 	independence=3 	domination=2
FCpUw 	independence=3 	domination=2
FCpVw 	independence=3 	domination=1
FCrf_ 	independence=3 	domination=3
FCrfO 	independence=3 	domination=3
FCreo 	independence=3 	domination=2
FCrdo 	independence=3 	domination=2
FCrbo 	independence=3 	domination=2
FCreW 	independence=3 	domination=3
FCrfo 	independence=3 	domination=2
FCrfg 	independence=3 	domination=2
FCrfW 	independence=3 	domination=2
FCrfw 	independence=3 	domination=1
FCrQo 	independence=3 	domination=3
FCrUo 	independence=3 	domination=3
FCrRo 	independence=3 	domination=2
FCrVG 	independence=3 	domination=3
FCrUW 	independence=3 	domination=3
FCrVo 	independence=3 	domination=2
FCrVg 	independence=3 	domination=2
FCrVW 	independence=3 	domination=2
FCrUw 	independence=3 	domination=2
FCrVw 	independence=3 	domination=1
FCpv? 	independence=3 	domination=3
FCptO 	independence=3 	domination=2
FCpv_ 	independence=3 	domination=3
FCpvO 	independence=3 	domination=2
FCpuo 	independence=3 	domination=2
FCpug 	independence=3 	domination=3
FCprg 	independence=3 	domination=2
FCpvo 	independence=3 	domination=2
FCpvg 	independence=3 	domination=2
FCpvW 	independence=3 	domination=2
FCpuw 	independence=3 	domination=2
FCpvw 	independence=3 	domination=1
FCrJo 	independence=3 	domination=2
FCrMW 	independence=3 	domination=3
FCrLW 	independence=3 	domination=3
FCrKw 	independence=3 	domination=3
FCrIw 	independence=3 	domination=3
FCrHw 	independence=3 	domination=2
FCrNo 	independence=3 	domination=2
FCrNW 	independence=3 	domination=2
FCrMw 	independence=3 	domination=2
FCrLw 	independence=3 	domination=2
FCrJw 	independence=3 	domination=2
FCrNw 	independence=3 	domination=1
FCqn_ 	independence=3 	domination=2
FCqno 	independence=3 	domination=2
FCqnW 	independence=3 	domination=2
FCqnw 	independence=3 	domination=1
FCrro 	independence=3 	domination=2
FCrvo 	independence=3 	domination=2
FCrvg 	independence=3 	domination=2
FCruw 	independence=3 	domination=2
FCrrw 	independence=3 	domination=2
FCrvw 	independence=3 	domination=1
FCrno 	independence=3 	domination=2
FCrng 	independence=3 	domination=2
FCrnW 	independence=3 	domination=2
FCrmw 	independence=3 	domination=2
FCrlw 	independence=3 	domination=2
FCrjw 	independence=3 	domination=2
FCrnw 	independence=3 	domination=1
FCr^o 	independence=3 	domination=2
FCr]w 	independence=3 	domination=2
FCr^w 	independence=3 	domination=1
FCr~o 	independence=3 	domination=2
FCr~w 	independence=3 	domination=1
FCXf? 	independence=4 	domination=4
FCXe_ 	independence=3 	domination=3
FCXbO 	independence=3 	domination=3
FCXf_ 	independence=3 	domination=3
FCXfO 	independence=3 	domination=3
FCXeo 	independence=3 	domination=2
FCXbW 	independence=3 	domination=2
FCXfo 	independence=3 	domination=2
FCXfW 	independence=3 	domination=2
FCXfw 	independence=3 	domination=1
FCZf? 	independence=4 	domination=4
FCZb_ 	independence=3 	domination=3
FCZeO 	independence=3 	domination=3
FCZbO 	independence=3 	domination=3
FCZco 	independence=3 	domination=2
FCZf_ 	independence=3 	domination=3
FCZfO 	independence=3 	domination=3
FCZeo 	independence=3 	domination=2
FCZbo 	independence=3 	domination=2
FCZfG 	independence=3 	domination=3
FCZeg 	independence=3 	domination=2
FCZbg 	independence=3 	domination=3
FCZfo 	independence=3 	domination=2
FCZfg 	independence=3 	domination=2
FCZfW 	independence=3 	domination=2
FCZew 	independence=3 	domination=2
FCZbw 	independence=3 	domination=2
FCZfw 	independence=3 	domination=1
FCZV? 	independence=3 	domination=3
FCZUO 	independence=3 	domination=3
FCZTO 	independence=3 	domination=2
FCZSo 	independence=3 	domination=3
FCZV_ 	independence=3 	domination=3
FCZVO 	independence=3 	domination=2
FCZUo 	independence=3 	domination=3
FCZTo 	independence=3 	domination=2
FCZUg 	independence=3 	domination=2
FCZTg 	independence=3 	domination=2
FCZVo 	independence=3 	domination=2
FCZVg 	independence=3 	domination=2
FCZVW 	independence=3 	domination=2
FCZUw 	independence=3 	domination=2
FCZTw 	independence=3 	domination=2
FCZVw 	independence=3 	domination=1
FCZN_ 	independence=3 	domination=2
FCZMo 	independence=3 	domination=2
FCZLo 	independence=3 	domination=2
FCZJo 	independence=3 	domination=2
FCZNG 	independence=3 	domination=3
FCZMg 	independence=3 	domination=2
FCZLg 	independence=3 	domination=2
FCZJg 	independence=3 	domination=2
FCZMW 	independence=3 	domination=3
FCZLW 	independence=3 	domination=3
FCZKw 	independence=3 	domination=2
FCZIw 	independence=3 	domination=3
FCZHw 	independence=3 	domination=2
FCZNo 	independence=3 	domination=2
FCZNg 	independence=3 	domination=2
FCZNW 	independence=3 	domination=2
FCZMw 	independence=3 	domination=2
FCZLw 	independence=3 	domination=2
FCZJw 	independence=3 	domination=2
FCZNw 	independence=3 	domination=1
FCXn_ 	independence=3 	domination=2
FCXnO 	independence=3 	domination=3
FCXmo 	independence=3 	domination=2
FCXmW 	independence=3 	domination=3
FCXjW 	independence=3 	domination=2
FCXkw 	independence=3 	domination=2
FCXno 	independence=3 	domination=2
FCXnW 	independence=3 	domination=2
FCXmw 	independence=3 	domination=2
FCXnw 	independence=3 	domination=1
FCY^_ 	independence=3 	domination=2
FCY^O 	independence=3 	domination=2
FCY]o 	independence=3 	domination=2
FCY^G 	independence=3 	domination=2
FCY]g 	independence=3 	domination=2
FCY[w 	independence=3 	domination=2
FCY^o 	independence=3 	domination=2
FCY^g 	independence=3 	domination=2
FCY^W 	independence=3 	domination=2
FCY]w 	independence=3 	domination=2
FCY^w 	independence=3 	domination=1
FCZv_ 	independence=3 	domination=3
FCZvo 	independence=3 	domination=2
FCZvg 	independence=3 	domination=2
FCZvw 	independence=3 	domination=1
FCZn_ 	independence=3 	domination=2
FCZno 	independence=3 	domination=2
FCZng 	independence=3 	domination=2
FCZnW 	independence=3 	domination=2
FCZmw 	independence=3 	domination=2
FCZjw 	independence=3 	domination=2
FCZnw 	independence=3 	domination=1
FCZ^_ 	independence=3 	domination=2
FCZ^o 	independence=3 	domination=2
FCZ^g 	independence=3 	domination=2
FCZ]w 	independence=3 	domination=2
FCZ\w 	independence=3 	domination=2
FCZ^w 	independence=3 	domination=1
FCZ~o 	independence=3 	domination=2
FCZ~w 	independence=3 	domination=1
FCdb? 	independence=3 	domination=3
FCde_ 	independence=3 	domination=3
FCdco 	independence=3 	domination=2
FCdeG 	independence=3 	domination=3
FCdbG 	independence=3 	domination=2
FCdcg 	independence=4 	domination=3
FCdf_ 	independence=3 	domination=3
FCdeo 	independence=3 	domination=2
FCdfG 	independence=3 	domination=2
FCdeg 	independence=3 	domination=3
FCdcw 	independence=3 	domination=2
FCdfo 	independence=3 	domination=2
FCdfg 	independence=3 	domination=2
FCdew 	independence=3 	domination=2
FCdfw 	independence=3 	domination=1
FCe[w 	independence=3 	domination=3
FCe^o 	independence=3 	domination=2
FCe]w 	independence=3 	domination=2
FCe^w 	independence=3 	domination=1
FCfvo 	independence=3 	domination=2
FCfvg 	independence=3 	domination=2
FCfvW 	independence=3 	domination=2
FCfuw 	independence=3 	domination=2
FCfvw 	independence=3 	domination=1
FCf^o 	independence=3 	domination=2
FCf]w 	independence=3 	domination=2
FCf\w 	independence=3 	domination=2
FCf^w 	independence=3 	domination=1
FCf~o 	independence=3 	domination=2
FCf~w 	independence=3 	domination=1
FCzf_ 	independence=3 	domination=3
FCzfO 	independence=3 	domination=3
FCzbo 	independence=3 	domination=2
FCzeW 	independence=3 	domination=3
FCzbW 	independence=3 	domination=2
FCzcw 	independence=3 	domination=2
FCzaw 	independence=3 	domination=2
FCzfo 	independence=3 	domination=2
FCzfW 	independence=3 	domination=2
FCzew 	independence=3 	domination=2
FCzbw 	independence=3 	domination=2
FCzfw 	independence=3 	domination=1
FCxv? 	independence=3 	domination=3
FCxv_ 	independence=3 	domination=3
FCxvO 	independence=3 	domination=2
FCxuW 	independence=3 	domination=2
FCxrW 	independence=3 	domination=3
FCxsw 	independence=3 	domination=2
FCxvo 	independence=3 	domination=2
FCxvW 	independence=3 	domination=2
FCxuw 	independence=3 	domination=2
FCxvw 	independence=3 	domination=1
FCzro 	independence=3 	domination=2
FCzvo 	independence=3 	domination=2
FCzvg 	independence=3 	domination=2
FCzrw 	independence=3 	domination=2
FCzvw 	independence=3 	domination=1
FCzno 	independence=3 	domination=2
FCznW 	independence=3 	domination=2
FCzmw 	independence=3 	domination=2
FCzjw 	independence=3 	domination=2
FCznw 	independence=3 	domination=1
FCz^o 	independence=3 	domination=2
FCz^g 	independence=3 	domination=2
FCz]w 	independence=3 	domination=2
FCz\w 	independence=3 	domination=2
FCz^w 	independence=3 	domination=1
FCx}w 	independence=3 	domination=2
FCx~w 	independence=3 	domination=1
FCz~w 	independence=3 	domination=1
FCvfO 	independence=3 	domination=3
FCveo 	independence=3 	domination=2
FCvdo 	independence=3 	domination=2
FCvbo 	independence=3 	domination=2
FCvfG 	independence=3 	domination=2
FCveg 	independence=3 	domination=3
FCvdg 	independence=3 	domination=2
FCvbg 	independence=3 	domination=2
FCvdW 	independence=3 	domination=2
FCvbW 	independence=3 	domination=2
FCvcw 	independence=3 	domination=2
FCvaw 	independence=3 	domination=2
FCv`w 	independence=3 	domination=2
FCvfo 	independence=3 	domination=2
FCvfg 	independence=3 	domination=2
FCvfW 	independence=3 	domination=2
FCvew 	independence=3 	domination=2
FCvdw 	independence=3 	domination=2
FCvbw 	independence=3 	domination=2
FCvfw 	independence=3 	domination=1
FCvUo 	independence=3 	domination=3
FCvUW 	independence=3 	domination=3
FCvRW 	independence=3 	domination=2
FCvSw 	independence=3 	domination=3
FCvVo 	independence=3 	domination=2
FCvVW 	independence=3 	domination=2
FCvUw 	independence=3 	domination=2
FCvTw 	independence=3 	domination=2
FCvVw 	independence=3 	domination=1
FCuto 	independence=3 	domination=3
FCuuW 	independence=3 	domination=2
FCurW 	independence=3 	domination=2
FCusw 	independence=3 	domination=3
FCuvo 	independence=3 	domination=2
FCuvW 	independence=3 	domination=2
FCuuw 	independence=3 	domination=2
FCuvw 	independence=3 	domination=1
FCvvo 	independence=3 	domination=2
FCvvg 	independence=3 	domination=2
FCvtw 	independence=3 	domination=2
FCvvw 	independence=3 	domination=1
FCv^o 	independence=3 	domination=2
FCv]w 	independence=3 	domination=2
FCv\w 	independence=3 	domination=2
FCv^w 	independence=3 	domination=1
FCu~w 	independence=3 	domination=1
FCv~w 	independence=3 	domination=1
FC~vo 	independence=3 	domination=2
FC~vW 	independence=3 	domination=2
FC~uw 	independence=3 	domination=2
FC~vw 	independence=3 	domination=1
FC~~w 	independence=3 	domination=1
FErvo 	independence=3 	domination=2
FErvg 	independence=3 	domination=2
FErvW 	independence=3 	domination=2
FEruw 	independence=3 	domination=2
FErtw 	independence=3 	domination=2
FErvw 	independence=3 	domination=1
FEr]o 	independence=3 	domination=3
FEr^o 	independence=3 	domination=2
FEr]w 	independence=3 	domination=2
FEr^w 	independence=3 	domination=1
FEr~o 	independence=3 	domination=2
FEr~w 	independence=3 	domination=1
FEhf? 	independence=4 	domination=4
FEhe_ 	independence=3 	domination=3
FEhd_ 	independence=3 	domination=3
FEhf_ 	independence=3 	domination=3
FEheo 	independence=3 	domination=2
FEhbo 	independence=3 	domination=3
FEhfo 	independence=3 	domination=2
FEhfw 	independence=3 	domination=1
FEjf_ 	independence=3 	domination=3
FEjeo 	independence=3 	domination=2
FEjbo 	independence=3 	domination=2
FEjfG 	independence=3 	domination=3
FEjeg 	independence=3 	domination=2
FEjdg 	independence=3 	domination=3
FEjfo 	independence=3 	domination=2
FEjfg 	independence=3 	domination=2
FEjfw 	independence=3 	domination=1
FEiro 	independence=3 	domination=2
FEitW 	independence=3 	domination=2
FEivo 	independence=3 	domination=2
FEivg 	independence=3 	domination=2
FEivW 	independence=3 	domination=2
FEitw 	independence=3 	domination=2
FEivw 	independence=3 	domination=1
FEhv? 	independence=3 	domination=3
FEhuO 	independence=3 	domination=2
FEhvO 	independence=3 	domination=2
FEhuo 	independence=3 	domination=2
FEhto 	independence=3 	domination=2
FEhro 	independence=3 	domination=3
FEhtg 	independence=3 	domination=3
FEhvo 	independence=3 	domination=2
FEhvg 	independence=3 	domination=2
FEhuw 	independence=3 	domination=2
FEhtw 	independence=3 	domination=2
FEhvw 	independence=3 	domination=1
FEjvo 	independence=3 	domination=2
FEjvg 	independence=3 	domination=2
FEjvW 	independence=3 	domination=2
FEjuw 	independence=3 	domination=2
FEjtw 	independence=3 	domination=2
FEjrw 	independence=3 	domination=2
FEjvw 	independence=3 	domination=1
FEj^o 	independence=3 	domination=2
FEj]w 	independence=3 	domination=2
FEj\w 	independence=3 	domination=2
FEj^w 	independence=3 	domination=1
FEh}o 	independence=3 	domination=2
FEhzo 	independence=3 	domination=2
FEh~o 	independence=3 	domination=2
FEh}w 	independence=3 	domination=2
FEhzw 	independence=3 	domination=2
FEh~w 	independence=3 	domination=1
FEj~o 	independence=3 	domination=2
FEj~w 	independence=3 	domination=1
FEzf_ 	independence=3 	domination=3
FEzfO 	independence=3 	domination=3
FEzeW 	independence=3 	domination=3
FEzfo 	independence=3 	domination=2
FEzfW 	independence=3 	domination=2
FEzfw 	independence=3 	domination=1
FEzV_ 	independence=3 	domination=3
FEzVO 	independence=3 	domination=2
FEzUo 	independence=3 	domination=3
FEzUg 	independence=3 	domination=2
FEzTg 	independence=3 	domination=2
FEzSw 	independence=3 	domination=2
FEzPw 	independence=3 	domination=2
FEzVo 	independence=3 	domination=2
FEzVg 	independence=3 	domination=2
FEzUw 	independence=3 	domination=2
FEzTw 	independence=3 	domination=2
FEzVw 	independence=3 	domination=1
FEzvO 	independence=3 	domination=2
FEzvo 	independence=3 	domination=2
FEzvg 	independence=3 	domination=2
FEzvw 	independence=3 	domination=1
FEzno 	independence=3 	domination=2
FEznW 	independence=3 	domination=2
FEznw 	independence=3 	domination=1
FEz~w 	independence=3 	domination=1
FEvvo 	independence=3 	domination=2
FEvvg 	independence=3 	domination=2
FEvvW 	independence=3 	domination=2
FEvvw 	independence=3 	domination=1
FEv^o 	independence=3 	domination=2
FEv]w 	independence=3 	domination=2
FEv\w 	independence=3 	domination=2
FEv^w 	independence=3 	domination=1
FEu~o 	independence=3 	domination=2
FEu~g 	independence=3 	domination=2
FEu|w 	independence=3 	domination=2
FEu~w 	independence=3 	domination=1
FEv~w 	independence=3 	domination=1
FEnf_ 	independence=3 	domination=3
FEnbo 	independence=3 	domination=2
FEndg 	independence=3 	domination=3
FEnbg 	independence=3 	domination=2
FEncw 	independence=3 	domination=2
FEnaw 	independence=3 	domination=2
FEnfo 	independence=3 	domination=2
FEnfg 	independence=3 	domination=2
FEnew 	independence=3 	domination=2
FEnbw 	independence=3 	domination=2
FEnfw 	independence=3 	domination=1
FEnvo 	independence=3 	domination=2
FEnvg 	independence=3 	domination=2
FEnvW 	independence=3 	domination=2
FEnvw 	independence=3 	domination=1
FEl~o 	independence=3 	domination=2
FEl}w 	independence=3 	domination=2
FEl~w 	independence=3 	domination=1
FEn~w 	independence=3 	domination=1
FE~vo 	independence=3 	domination=2
FE~vW 	independence=3 	domination=2
FE~uw 	independence=3 	domination=2
FE~tw 	independence=3 	domination=2
FE~vw 	independence=3 	domination=1
FE~~w 	independence=3 	domination=1
FFzf_ 	independence=3 	domination=3
FFzeo 	independence=3 	domination=2
FFzfo 	independence=3 	domination=2
FFzfw 	independence=3 	domination=1
FFzvO 	independence=3 	domination=2
FFzvo 	independence=3 	domination=2
FFzvg 	independence=3 	domination=2
FFzvw 	independence=3 	domination=1
FFz~o 	independence=3 	domination=2
FFz~w 	independence=3 	domination=1
FF~~w 	independence=3 	domination=1
FQhV? 	independence=3 	domination=3
FQhTO 	independence=2 	domination=2
FQhV_ 	independence=3 	domination=3
FQhVO 	independence=2 	domination=2
FQhVo 	independence=2 	domination=2
FQhVw 	independence=2 	domination=1
FQjdo 	independence=3 	domination=2
FQjfG 	independence=3 	domination=3
FQjdg 	independence=3 	domination=3
FQjfo 	independence=3 	domination=2
FQjfg 	independence=3 	domination=2
FQjfW 	independence=3 	domination=2
FQjew 	independence=3 	domination=2
FQjdw 	independence=3 	domination=2
FQjfw 	independence=3 	domination=1
FQjR_ 	independence=3 	domination=3
FQjV_ 	independence=3 	domination=3
FQjVO 	independence=2 	domination=2
FQjRo 	independence=2 	domination=2
FQjVG 	independence=3 	domination=3
FQjUg 	independence=2 	domination=2
FQjVo 	independence=2 	domination=2
FQjVg 	independence=2 	domination=2
FQjVw 	independence=2 	domination=1
FQinO 	independence=3 	domination=3
FQilW 	independence=2 	domination=2
FQino 	independence=2 	domination=2
FQinW 	independence=2 	domination=2
FQinw 	independence=2 	domination=1
FQjvo 	independence=2 	domination=2
FQjvg 	independence=2 	domination=2
FQjvW 	independence=2 	domination=2
FQjuw 	independence=2 	domination=2
FQjvw 	independence=2 	domination=1
FQjno 	independence=2 	domination=2
FQjnW 	independence=2 	domination=2
FQjlw 	independence=2 	domination=2
FQjnw 	independence=2 	domination=1
FQj~o 	independence=2 	domination=2
FQj~w 	independence=2 	domination=1
FQzV_ 	independence=3 	domination=3
FQzVO 	independence=2 	domination=2
FQzUo 	independence=3 	domination=3
FQzTo 	independence=2 	domination=2
FQzUW 	independence=3 	domination=3
FQzVo 	independence=2 	domination=2
FQzVW 	independence=2 	domination=2
FQzVw 	independence=2 	domination=1
FQyv_ 	independence=3 	domination=3
FQyvO 	independence=2 	domination=2
FQyuo 	independence=2 	domination=2
FQyuW 	independence=3 	domination=2
FQytW 	independence=2 	domination=3
FQyqw 	independence=2 	domination=2
FQyvo 	independence=2 	domination=2
FQyvW 	independence=2 	domination=2
FQyuw 	independence=2 	domination=2
FQyvw 	independence=2 	domination=1
FQzvO 	independence=2 	domination=2
FQzuo 	independence=2 	domination=2
FQzvo 	independence=2 	domination=2
FQzvg 	independence=2 	domination=2
FQzvw 	independence=2 	domination=1
FQzno 	independence=2 	domination=2
FQznW 	independence=2 	domination=2
FQzmw 	independence=2 	domination=2
FQzlw 	independence=2 	domination=2
FQznw 	independence=2 	domination=1
FQz^o 	independence=2 	domination=2
FQz^w 	independence=2 	domination=1
FQy~o 	independence=2 	domination=2
FQy}w 	independence=2 	domination=2
FQy~w 	independence=2 	domination=1
FQz~w 	independence=2 	domination=1
FQ~vo 	independence=2 	domination=2
FQ~vW 	independence=2 	domination=2
FQ~vw 	independence=2 	domination=1
FQ~~w 	independence=2 	domination=1
FUZv_ 	independence=3 	domination=3
FUZvo 	independence=2 	domination=2
FUZvg 	independence=2 	domination=2
FUZvW 	independence=2 	domination=2
FUZuw 	independence=2 	domination=2
FUZvw 	independence=2 	domination=1
FUZ~o 	independence=2 	domination=2
FUZ~w 	independence=2 	domination=1
FUxv_ 	independence=3 	domination=3
FUxvO 	independence=2 	domination=2
FUxuo 	independence=2 	domination=2
FUxvo 	independence=2 	domination=2
FUxvw 	independence=2 	domination=1
FUzro 	independence=2 	domination=2
FUzvo 	independence=2 	domination=2
FUzvW 	independence=2 	domination=2
FUzvw 	independence=2 	domination=1
FUz^o 	independence=2 	domination=2
FUz]w 	independence=2 	domination=2
FUz^w 	independence=2 	domination=1
FUz~w 	independence=2 	domination=1
FU~vo 	independence=2 	domination=2
FU~vW 	independence=2 	domination=2
FU~vw 	independence=2 	domination=1
FU~~w 	independence=2 	domination=1
FTzvo 	independence=2 	domination=2
FTzvg 	independence=2 	domination=2
FTzvW 	independence=2 	domination=2
FTzvw 	independence=2 	domination=1
FTznw 	independence=2 	domination=1
FTz~w 	independence=2 	domination=1
FTnvo 	independence=2 	domination=2
FTnvg 	independence=2 	domination=2
FTnvw 	independence=2 	domination=1
FTm~o 	independence=2 	domination=2
FTm|w 	independence=2 	domination=2
FTm~w 	independence=2 	domination=1
FTn~w 	independence=2 	domination=1
FT~~w 	independence=2 	domination=1
FV~~w 	independence=2 	domination=1
F]zno 	independence=2 	domination=2
F]znW 	independence=2 	domination=2
F]zlw 	independence=2 	domination=2
F]znw 	independence=2 	domination=1
F]y~w 	independence=2 	domination=1
F]z~w 	independence=2 	domination=1
F]~vo 	independence=2 	domination=2
F]~vw 	independence=2 	domination=1
F]~~w 	independence=2 	domination=1
F^~~w 	independence=2 	domination=1
F~~~w 	independence=1 	domination=1
real	0m0,011s